TILEMAP
images/tileSet3.png
16 16
19,33,23,24,25,23,24,25,26,23,23,24,25,26,23,24,25,23,24,25,26,25,23,24,25,23,23,24,25,26,34,14
11,12,32,0,0,0,0,0,0,0,0,0,0,0,0,0,0,0,0,0,0,0,0,0,0,0,0,0,0,48,29,30
27,28,32,0,0,0,0,0,0,0,0,0,0,0,0,0,0,0,0,0,0,0,0,0,0,0,0,0,0,48,45,46
43,44,0,0,0,0,0,0,0,0,0,0,0,0,0,0,0,0,0,0,0,0,0,0,0,0,0,0,0,0,13,14
59,60,0,0,0,0,0,0,0,0,0,0,0,0,0,0,0,0,0,0,0,0,0,0,112,0,0,0,0,0,29,30
11,12,1,2,0,0,1,2,1,2,1,2,1,2,0,0,1,2,1,2,1,2,1,2,1,2,1,2,0,0,45,46
11,12,0,0,0,0,15,39,40,39,40,41,42,47,0,0,0,0,0,0,0,48,67,0,0,70,101,102,0,0,13,14
27,28,0,0,0,0,29,55,56,55,56,57,58,28,0,0,0,0,0,0,0,48,83,0,0,86,117,0,0,0,29,30
43,44,0,0,1,2,45,46,7,8,10,9,43,44,0,0,0,0,0,0,0,0,83,1,2,86,0,0,1,2,45,46
59,60,0,0,0,0,45,46,9,10,8,9,10,60,0,0,0,0,0,0,0,0,83,0,0,86,0,0,123,124,61,62
11,12,0,0,0,0,50,24,25,26,24,25,26,49,1,2,1,2,0,0,1,2,83,0,0,86,0,0,0,0,13,14
27,28,1,2,0,0,0,0,0,0,0,0,0,0,65,66,0,0,0,0,0,0,83,1,2,86,1,2,0,0,29,30
43,44,0,0,0,0,0,0,0,0,0,0,0,0,81,82,0,0,0,0,0,0,83,0,0,86,107,108,0,0,45,46
59,60,0,0,0,0,0,0,0,0,0,0,0,0,81,82,1,2,0,0,1,2,83,0,0,86,123,124,0,0,61,62
11,12,0,0,1,2,1,2,1,2,1,2,1,2,81,82,0,0,0,0,0,0,83,1,2,86,0,0,1,2,13,14
27,28,0,0,198,0,0,0,0,0,0,0,0,0,81,82,0,0,0,0,0,0,83,0,0,86,0,0,0,0,13,14
11,12,122,138,0,0,0,0,0,0,0,0,0,0,81,82,0,0,0,0,1,2,83,0,0,86,0,0,0,0,29,30
27,28,213,214,0,0,0,0,0,0,0,0,1,2,81,82,1,2,0,0,0,0,83,1,2,86,1,2,0,0,45,46
11,12,229,230,231,232,233,234,234,234,234,234,235,236,97,98,32,0,0,0,0,0,0,0,0,86,0,0,0,0,13,14
27,28,245,246,247,248,249,250,250,250,250,250,251,252,97,98,0,0,0,0,0,0,0,0,0,86,0,125,126,0,29,30
43,44,1,2,1,2,1,2,1,2,1,2,1,2,113,114,1,2,1,2,1,2,205,1,2,205,1,2,1,2,45,46
59,63,39,40,41,42,39,39,40,41,42,42,39,40,41,39,40,41,39,40,41,42,221,40,41,221,39,40,41,42,31,62
TILEMAP
23.5 15.5	//Pos llave
14 8		//Pos puerta
28 16 0 	//Player
3		//Num enemigos
1 21 3 0
0 8 18 1
2 16 11 1
4
1 2 15 
2 7 2
2 12 2
0 13 15
0
