14,14,14,14,14,14,14,14,14,14,14,14,14,14,14,14
14,0,0,0,0,0,0,0,0,0,19,0,46,0,0,14
14,0,0,0,61,0,0,0,0,0,19,0,49,0,0,14
14,0,59,59,60,59,59,0,0,0,25,0,0,0,0,14
14,0,0,0,0,0,0,0,59,59,0,0,0,0,0,14
14,0,0,0,0,0,0,0,0,0,0,59,59,59,0,14
14,0,0,0,0,0,0,0,0,0,0,0,0,0,0,14
14,0,59,59,59,59,0,0,59,59,59,59,0,0,0,14
14,0,0,0,0,0,0,0,0,0,0,0,0,0,0,14
14,0,0,0,0,0,0,0,0,0,0,0,0,0,0,14
14,14,14,14,54,54,54,54,54,54,54,54,14,42,42,14
